111111111111111111111111111111111111111
1000000P000001000000000000C010000000E01
1000000000000000C00000000000000C0000001
1000001000000100000100000000C0000001001
1000000000000000C00000000000000C0000001
1000000CCCC0000000000000C000000C0000001
100000000000000000000000000000000000001
111111111111111111111111111111111111111