1111111111
1000100001
10C0111001
1P00000001
1000000001
1000000001
1000000001
100000C001
10000000E1
1111111111