111111111111111111
1000000P00000000E1
1000000CCC000000C1
111111111111111111